R 10000 10000

NO ./textures/bluestone.xpm
SO ./textures/eagle.xpm
WE ./textures/greystone.xpm
EA ./textures/purplestone.xpm
S ./textures/pillar.xpm

F 0,33,33
C 255,255,255

11111111111111111111111111
10000000000000000000000001
10000000000N00000000000001
10000000000000000000000001
11111111111111111111111111