    R 640 480

       NO ./textures/bluestone.xpm
  SO             ./textures/eagle.xpm
     WE ./textures/greystone.xpm
EA ./textures/purplestone.xpm
    S ./textures/pillar.xpm

F 0,33,33
    C     0,0,255

000000000000000000000000000011111111111110000
     1111110000000000000000010000000000010000
000001000010000001111111111110000000000011111
000001000001000001000000000010000000000010001
000001000001000001000000000000000000000000001
000001000001000001000000000010000000000010001
000001110111111101000111111110000000000011111
000001000000000101000100000010000000000010000
000001000000000111000111000001111011111110000
000001000000000100000001000000010001100000000
000001000000000000000001000000010001100000000
111111000000000111111111000000010001100000000
100011000000000100000000000000010001111000000
100011111101111000000000000000010000011000000
100010001000100000000000000000010001111000000
110110001000100000000000000000010001100000000
100011111000100000000000000000010001100000000
100010001000100000000000000000010001100000000
100000001000100000000000000000010001100000000
100010001000100000000000000000010001100000000
100011111101111100000000000000111011110000000
100011000000000100000000011111100000111111110
100011000000000100000000010000000000000000110
1000110000000001000000000100000000000000001111111111111111111111
1000010000000001000000000100000000000000000100000000001000000001
1000000000000001000000000100000000000000000000000000000000000001
1000010000000001000000000100000000000000000100000000001000000001
1000110000000001000000000100000000000000001111000011111000000001
1000110000000001000000000100000000000000001111100100001000000001
1000110000000001000000000111111100011111111000100100001000000001
1000111111011111000000000000000110110000000000100100001000000001
1000111110001000000000000000000100010000000000100100001111111111
10001111100010000000000000000001000100000000001001
1000100010001000000000000000000100010000000000100100101010100
1000000010001000000000000000000100010000000000100111010101011
1000100010001000000000000000000100010000000000100010000000001
1000111110001000000000000000000100010000000000100010000000001
1000111110001111111111110000000100010000000000111111010101011
1000000000000000010000011100000100010000000000000000101010100
10000000000000000000000001000001000100000
10000000000000000100000111000001000100000
11111111111111111111111100000001000100000
00000000000000000000000000111111101111111
00000000000000000000000000100001000100001
00000000000000000000000000100000000000001
00000000000000000000000000100001000100001
00000000000000000000000000111111000111111
000000000000000000000000001    1000100201
0000000000000000000000000010W000000002001
00000000000000000000000000100001000100201
00000000000000000000000000111111000111111
00000000000000000000000000100000000000001
00000000000000000000000000100000000000001
                          100000000000001
00000000000000000000000000111111111111111